R 720 480
NO textures/wood.xpm
SO textures/greystone.xpm
WE textures/redbrick.xpm
EA textures/eagle.xpm
F 75,74,74
C 1,10,254

111111111111111111111111
111111111111111111111111
100000000000000000000001 
100000000000000000000001 
100000000000000000000001
100000000000000000000001
100000000000000000000001
100000000000000000000001
110000000110000111110001
110000000110000111110001
100000000000000000010001
100000000000000000010001
100000000010000100010001
100000000010000100010001
100000000010000110010001
100000000010000110010001
100000111110000100000001
100000111110000100000001
100000000000000000000001
100000000000000000000001
100000000000000000000001
100000000000000000000001
100000000000000000000001 
100000000000000000000001 
111000000000000000000001
100000000000000000000001
101110000000000000000001111111111111
1000010000000000000000000000000000001
1000000000000000000000011111111111101
100000000000000000000001          101 
100000000000000000000001          101 
10000000000000000000000111111111111011111111111
100000000000000000000000000000000000000000000001
100000000000000000000000000000000000000000000001
100000000000000000000000000000000000000000000001
10000000000000N0000000000000000000000000000000001
1000000000000000000000000000000000000000000000000111
100000000000000000000000000000000000000000000000000011
1000000000000000000000000000000000000000000000000000001
100000000000000000000000000000000000000000000000000001
100000000000000000000000000000000000000000000000000001
10000000000000000000000000000000000000000000000000001
1000000000000000000000000000000000000000000000000001
100000000000000000000000000000000000000000000000011
10000000000000000000000000000000000000000000000001
10000000000000000000000000000000000000000000000001
10000000000000000000000000000000000000000000000001
1000000000000000000000000000000000000000000000011
100000000000000000000000000000000000000000000001
100000000000000000000000000000000000000000000001
100000000000000000000000000000000000000000000001
100000000000000000000000000000000000000000000001
100000000000000000000000000000000000000000000001
100000000000000000000000000000000000000000000001
100000000000000000000000000000000000000000000001
100000000000000000000000000000000000000000000001
100000000000000000000000000000000000000000000001
100000000000000000000000000000000000000000000001
100000000000000000000000000000000000000000000001
100000000000000000000000000000000000000000000001
100000000000000000000000000000000000000000000001
100000000000000000000000000000000000000000000001
100000000000000000000000000000000000000000000001
100000000000000000000000000000000000000000000001
100000000000000000000000000000000000000000000001
1000000000000000000000000000000000000000000000011111111111111111111111111111111111
1000000000000000000000000000000000000000000000000000000000000000000000000000000001
1000000000000000000000000000000000000000000000000000000000000000000000000000000001
1000000000000000000000000000000000000000000000000000000000000000000000000000000001
1000000000000000000000000000000000000000000000000000000000000000000000000000000001
1000000000000000000000000000000000000000000000000000000000000000000000000000000001
1000000000000000000000000000000000000000000000000000000000000000000000000000000001
1000000000000000000000000000000000000000000000000000000000000000000000000000000001
1000000000000000000000000000000000000000000000000000000000000000000000000000000001
1000000000000000000000000000000000000000000000000000000000000000000000000000000001
1000000000000000000000000000000000000000000000000000000000000000000000000000000001
1000000000000000000000000000000000000000000000000000000000000000000000000000000001
1000000000000000000000000000000000000000000000000000000000000000000000000000000001
1000000000000000000000000000000000000000000000000000000000000000000000000000000001
1000000000000000000000000000000000000000000000000000000000000000000000000000000001
1000000000000000000000000000000000000000000000000000000000000000000000000000000001
1000000000000000000000000000000000000000000000011111111111111111111111111111111111
100000000000000000000000000000000000000000000001
111111111111111111111111111111111110000000000001
100000000000000000000000000000000000000000000001
100000000000000000000000000000000000000000000001
100000000000000000000111111111111111111111111111
100000000000000000000000000000000000000000000001
100000000000000000000000000000000000000000000001
100000000000000000000000000000000000000000000001
100000000000000000000000000000000000000000000001
100000000000000000000000000000000000000000000001
100000000000000000000000000000000000000000000001
100000000000000000000000000000000000000000000001
100000000000000000000000000000000000000000000001
100000000000000000000000000000000000000000000001
100000000000000000000000000000000000000000000001
100000000000000000000000000000000000000000000001
100000000000000000000001111111111111111111111111
100000000000000000000001
100000000000000000000001
100000000000000000000001
100000000000000000000001
100000000000000000000001
100000000000000000000001
100000000000000000000001
100000000000000000000001
100000000000000000000001
100000000000000000000001
100000000000000000000001
100000000000000000000001
100000000000000000000001
100000000000000000000001
100000000000000000000001
100000000000000000000001
100000000000000000000001
100000000000000000000001
100000000000000000000001
100001000100010000011101
100000000000000000000001
100000000000000000000001
100000000000000000000001
100000000000000000000001
100000000000000000000001
100000000001000000100001
100000000000000000000001
100000000000000000000001
100000000000000000000001
101001010000001000000101
101001010000001000000101
101001010000001000000101
101001010000001000000101
101001010000001000000101
101001010000001000000101
101001010000001000000101
101001010000001000000101
101001010000001000000101
101001010000001000000101
101001010000001000000101
101001010000001000000101
101001010000001000000101
101001010000001000000101
101001010000001000000101
101001010000001000000101
101001010000001000000101
101001010000001000000101
101001010000001000000101
101001010000001000000101
101001010000001000000101
101001010000001000000101
101001010000001000000101
101001010000001000000101
101001010000001000000101
101001010000001000000101
101001010000001000000101
101001010000001000000101
101001010000001000000101
101001010000001000000101
101001010000001000000101
101001010000001000000101
101001010000001000000101
101001010000001000000101
101001010000001000000101
101001010000001000000101
101001010000001000000101
101001010000001000000101
101001010000001000000101
101001010000001000000101
101001010000001000000101
101001010000001000000101
101001010000001000000101
100000000000000000000001
111111111111111111111111