R 720 480
NO textures/wood.xpm
SO textures/greystone.xpm
WE textures/redbrick.xpm
EA textures/eagle.xpm
S textures/mv.xpm
F 0,    120, 0
C 70,170,190

11111111111111111111111100000000
1000000000110000000000001
1011000001110000002000001
1001000000000000000000001
111111111011000001110000000000001
100000000011000001110111111111111
11110111111111011100000010001
11110111111111011111111110001
110000001101010111000000102E1
10002000000000001100000000001
10000000000000001101010010001
1100000111010101111101111000111
11110111 1110101 101111010001
11111111 1111111 11111111111