R 720 480
NO images/wood.xpm
SO images/greystone.xpm
WE images/redbrick.xpm
EA images/eagle.xpm
S images/mv.xpm
F 75,74,74
C 1,10,254


  111 111 111 11111111                   
 1000100010001000000001
 1010101010101010000001
 1010101010101010020001
 1010101010101010000001
 1010101010101010002001
 1010101010101010000001
 1010101010101010200001
 1010101010101010002001
 1N10001000100010000001
1001111111101110110111
10100000000000000001
10001111111111111111
 1111
