R 720 480
NO images/wood.xpm
SO images/greystone.xpm
WE images/redbrick.xpm
EA images/eagle.xpm
S images/mv.xpm
F 75,74,74
C 1,10,254

  111
1100011
1100011
 1100011   
 1100011
 1100011
   1111
